###_###________#____###__
@___###_######___##_____#
_#________######_######_#
___#_#_##_#####____##_#_#
##__#__#_###____####__#_#
#___####_____##______##_X