###_###________#____####_
@___###_######___##_____#
_#________#############_#
___#_#_##_#############_#
##__#__##_##########____#
#___###################_X