###_####
@#__###_
_#_##X__
___#_#_#
##_____#
#__#####